NO assets/bluestone.png
SO assets/eagle.png
WE assets/eagle.png
EA assets/eagle.png

C 0,19,73
F 15,6,40




        111
     11110000   
   11100000001
  1100010000011
  1000000000001
 110000001000011
 100000000000001
 100000000000001
110000000000000
1000000010000000
1000000000000000
10000000000S010000000001
1000100000000000
1000000000000000
110000000000000
 100000000000001
 100000000000001
 110000000000011
  1000000000001
  1100000000011
   11100001001
     1111000
        1111111